44444444444444444444444444444444444444444444444444 
44444444444444444444444444444444044440444444444444 
44444444444444444444022222044444044440444444444444 
44444444444444444444222222244444044440444444444444 
44444444444444444444222222244444004440044444444444 
44444444444444444444222222244444004440004444444444 
44444444111114444444422222444444004440044444444444 
44444444133314444444000000044444005555555000444444 
44444444133314444444400000444444405555555500004444 
44444444133314444444440004444444445555555544444444 
44444444133314444444444554444444445555555544444444 
44444444111014444444444554444444445555555544444444 
44444444440044444444444554444444444555555444444444 
44444444440044444444444554444444444445544444444444 
44444444440044444444444554444444444445544444444444 
44444444440044444444444554444444444445544444444444 
44444444000044444444444554444444444445544444444444 
44444444000044444444444554444444444555544444444444 
44444444004444444444440504444444444555544444444444 
44444444004444444444400500444444444554444444444444 
44444444004455555555000500055555555555444444444444 
44444444004455555555555555555555555555444444444444 
44444444004404444444000500044444444455444444444444 
44444444004400444444400500444444444455444444444444 
44444444004400004444440504444444444455444444444444 
44444444004400004444444554444444444455444444444444 
44444444004444004444444554444444444455444444444444 
44444444004444004444444554404444444055444444444444 
44444444044444004444444554444404444455444444444444 
44444444000000004444444554444404444455444444444444 
44444444000000004444444554444444444405444444444444 
44444444000000044444444554444444444000444444444444 
44444444000000044444444554444444444000444444444444 
44444444000000044444444554444444444000444444444444 
44444444000000044444444554444444444000444444444444 
44444444444444444444440550444444444000444444444444 
44444444444444444440000000044444440000044444444444 
44444404444444444400000000004404400000044444444444 
44444444444444444400000000004444000000044444444444 
44444404444440444400000000000555000004044444444444 
44444444444444444400000000000000004000044444444444 
44444444000000444440000000044440000000044444444444 
44444444000004444444000000444440000000044444444444 
44444444400004444444400444444440000000044444444444 
44444444400000004444400444444444000000444444444444 
44444444444400000000000444444444444444444444444444 
44444444004400000000044444444444444444444444444444 
44444444444444444444444444444444444444444444444444 
44444444444444444444444444444444444444444444444444 
44444444444444444444444444444444444444444444444444  